|---------------|
|H   ##         |
|###    ## # ## |
|  # ####  ##   |
| ##    # ##  # |
|    # ##  ## # |
|# ###  ##### # |
|  #   #    #  #|
| ####   ## ##  |
|    #### # # ##|
| #  # ## # #   |
| ## #        # |
|  # #### # #   |
|###    # #  ## |
| ## ## ####   #|
|    ##     ##G#|
|---------------|
